51 50
O O X X X X X X X X X X X X X X X X X X X X X X X X X X X X X X X X X X X X X X X X X X X X X X X X 
O O O O O O O O O O O O X O O O X O X O O O O O X O O O X O O O O O O O X O O O O O O O O O O O O O 
X O X X X O X O X O X X X O X O X O X X X O X O X O X X X O X X X O X X X O X O X X X X X X X O X O 
X O O O X O X O X O O O X O X O X O X O X O X O X O O O X O X O X O X O O O X O O O X O O O O O X O 
X X X O X X X X X X X O X O X X X O X O X O X X X X X O X O X O X X X O X X X X X O X O X X X O X O 
X O O O O O O O O O X O O O O O O O O O O O X O X O O O O O X O O O X O O O O O X O X O O O X O X O 
X O X X X X X X X X X X X X X O X X X O X O X O X O X X X X X O X O X O X X X X X O X O X X X X X O 
X O O O X O X O O O O O O O O O X O O O X O O O X O X O X O O O X O O O X O O O X O X O O O X O O O 
X O X O X O X X X O X X X X X X X X X X X X X O X O X O X X X O X X X O X X X O X O X X X X X O X X 
X O X O O O O O X O O O O O O O X O O O O O X O O O X O O O X O X O O O X O X O X O X O O O X O O O 
X X X X X X X O X X X O X X X O X O X X X O X O X O X O X X X X X X X O X O X O X X X O X X X X X O 
X O X O O O O O X O O O X O X O X O O O X O X O X O O O X O O O O O O O O O X O X O O O X O O O X O 
X O X X X X X X X O X X X O X O X O X X X O X X X O X O X O X X X O X X X O X O X X X O X O X O X O 
X O O O O O O O X O O O X O O O O O O O X O O O X O X O O O O 2 X O X O O O O O O O O O X O X O X O 
X X X X X X X O X O X X X X X X X O X X X O X X X O X X X X X O X X X X X X X O X X X O X X X O X O 
X O O O X O O O X O X O O O X O O O X O O O X O O O X O O O O O X O X O O O X O X O O O O O X O X O 
X O X O X X X O X X X O X X X X X O X X X X X X X X X X X O X X X O X O X X X X X X X O X X X O X X 
X O X O X O O O X O X O O O O O O O O O O O O O O O X O O O O O O O X O O O O O O O O O O O O O X O 
X O X O X X X O X O X X X X X O X X X X X O X O X O X X X X X O X X X X X O X O X X X X X X X O X O 
X O X O O O X O O O X O O O X O O O O O X O X O X O X O O O O O X O O O X O X O X O O O X O O O O O 
X O X O X X X O X X X O X X X O X X X X X X X O X X X X X X X X X X X O X X X X X X X O X X X X X O 
X O X O O O X O O O O O X O X O O O O O X O O O X O X O O O O O X O O O O O X O O O O O O O O O O O 
X X X X X O X X X X X O X O X X X X X X X X X O X O X O X X X X X O X X X O X O X O X X X X X X X O 
X O O O O O X O O O X O O O O O O O X O O O O O O O O O X O O O X O O O X O O O X O O O O O X O O O 
X X X O X X X O X O X O X X X X X O X O X X X O X O X X X O X X X X X O X X X O X X X O X O X O X O 
X O O O X O O O X O X O X O X O O 1 X O O O X O X O O O O O X O X O X O O O X O X O O O X O X O X O 
X X X O X X X O X O X O X O X O X X X O X X X X X X X X X X X O X O X O X X X X X X X X X X X O X X 
X O X O X O O O X O O O O O X O O O X O O O X O O O O O X O X O O O X O X O O O X O O O O O O O O O 
X O X O X O X X X X X O X X X O X X X O X O X X X O X X X O X O X X X X X O X O X X X O X X X O X X 
X O X O X O X O O O O O X O O O X O X O X O O O O O X O X O O O O O X O X O X O O O X O X O O O X O 
X O X O X X X O X X X O X X X O X O X X X O X O X O X O X O X X X X X O X O X O X X X X X O X O X O 
X O X O O O X O X O O O X O O O X O X O X O X O X O X O X O O O O O X O O O X O O O O O X O X O O O 
X O X O X X X X X X X X X X X O X O X O X O X X X X X O X X X X X O X X X O X X X X X X X X X X X O 
X O X O X O O O X O O O O O O O O O X O X O X O O O X O O O X O O O O O O O O O O O O O O O O O X O 
X O X O X X X O X X X O X O X O X X X O X X X O X X X O X X X O X O X O X O X O X X X X X O X O X O 
X O O O O O O O X O O O X O X O O O X O O O X O X O O O O O O O X O X O X O X O X O X O O O X O O O 
X X X X X O X X X O X X X O X X X O X X X O X O X O X X X O X O X O X X X O X O X O X X X X X X X O 
X O O O O O X O X O O O X O X O O O O O O O O O X O X O X O X O X O O O X O X O O O X O X O X O O O 
X X X O X O X O X X X O X X X X X X X X X O X O X O X O X X X O X X X X X X X X X X X O X O X X X O 
X O O O X O O O X O X O O O X O O O X O X O X O O O X O X O O O O O O O X O O O O O O O X O O O O O 
X O X O X X X X X O X O X O X O X O X O X O X X X O X O X O X X X O X X X X X X X X X O X X X X X O 
X O X O O O O O O O O O X O X O X O O O O O X O X O X O O O X O X O O O X O O O O O O O O O O O X O 
X O X O X O X X X X X O X X X O X X X X X O X O X X X X X O X O X O X X X X X X X X X O X X X O X O 
X O X O X O X O O O O O X O O O O O O O X O X O O O X O O O X O X O X O O O O O O O X O X O O O O O 
X X X X X X X X X O X X X X X X X X X O X X X X X O X O X X X O X X X X X X X O X X X X X O X X X X 
X O O O O O O O O O X O O O O O O O O O O O O O X O O O O O O O O O X O O O O O O O O O O O O O O O 
X O X X X X X O X X X X X X X O X X X X X O X X X X X O X O X X X X X O X X X O X X X O X X X O X O 
X O O O O O X O O O O O X O X O X O X O O O O O X O O O X O X O O O O O O O X O X O O O X O O O X O 
X X X O X O X X X X X O X O X O X O X X X X X X X X X O X X X X X X X O X O X X X O X X X O X X X O 
X O O O X O X O O O O O X O O O O O X O O O O O O O O O O O X O O O O O X O X O O O X O O O X O O O 
X X X X X X X X X X X X X X X X X X X X X X X X X X X X X X X X X X X X X X X X X X X X X X X X X O 
